11111
11CE1
10PC1
101Q1
11111
11111
11111
11001
10001
10101
11111