1111111111111111111111111
10QE1000000000000011QCQC1
1000101Q00011000001100001
1110001000100100100111101
1011111001000010010010101
1001010011100100001001001
1000100000010000000000101
100CQ10101000111100100001
1001000100000001100010001
100100011QCCQCCQ100000001
1000100011111111110001001
111000000010Q1C0000000001
1C11000010100100011110001
1PQ1100010000100011110001
100000001C100000001100001
1111111111111111111111111