11111111111111111111
10000000000000000001
1000000000000000E001
10000000000000000001
1QQQQQQQQ1QQQQQQQQQ1
100000C0000000000001
10000000000000000001
1000000000000C000001
10000000000000000001
10P00000000000000001
11111111111111111111