111111111111111111111
100C000000000000E0001
100000000000000000001
100000000000000000001
100000000000000000001
100000000000000000001
100000000000000000001
100000000000000000001
1000P0000000000000001
100000000000000000001
100000000000000000001
111111111111111111111