111111111111111111111
110C0000000000Q0E0001
101000000000000000001
100100000000000000001
100010000000000000001
100001000000000000001
100000100000000000001
100000010000000000001
1CCCCCCCCCCCCCCCCCCC1
100000000100000P00001
110000000010000000001
111111111111111111111