111111111111111111111
110C00Q00000000QEQ001
101000Q00000000000001
100100000000000000001
100010000000000000001
100001000000000000001
100000100000000000001
100000010000000000001
1000000000000CCCCC001
10000000010000C0C0001
11000C00001000CCC00P1
111111111111111111111