111111
1E00Q1
100001
100001
100001
100001
100001
100001
100001
1CCCC1
1000P1
111111